1111111111111111111111111111111111111111111111111111111111111111111111
1000000000000000000000000000000000000000000000000000000000000000000001
1000000000000000000000000000000000000000000000000000000000000000000001
1000000000000000000000000000000000000000000000000000000000000000000001
1000000000000000000000000000000000000000000000000011111111111111111111
1000000000000000000000000000000000000000011111000000000000000000000001
1000000000000000000000000000000000000000000000000000000000000000000001
1000000000000000000000000011111111100000000000000000000000000000000001
1000000000000000000000000000000000000000000000000011111111111111111111
1000000000000000000000000000000000000000000000000000000000000000000001
1111111100000000000000000000000000000000001100000000000000000000000001
1000000000000000000000000000000000000000000000000000000001111100000001
1000000000000000000000000000000000000000000000000000000000000000000001
1000000000000011111111111111111100000000000000000000000000000000000001
1000000000000000000000000000000000000000000000000000000000000000000001
1000000000000000000000000000000000000000000000000000000000000000000001
1000000000000000000000000000000000000000111111111100000000000000000001
1000000000000000000000000000000000000000000000000000000000000000000001
1000000000000000000000000000000000000000000000000000000000000000000001
1000000000000000000000000000000000000000000000000000000000011111111111
1100011111000000000000000000000000000000000000000000000000000000000001
1000000000000000000000000000000000000000000000000000000000000000000001
1000000000000000011111111100000000000111111111000000000000000000000001
1000000000000000000000000000000000000000000000000000000000000000000001
1000000000000000000000000000000000000000000000000000000000000000000001
1111111111000000000000000000000000000000000000000000000000000000000001
1000000000000000000000000000000000000000000000000000000000000000000001
1000000000000000000000000000000000000000000000000000000000000000000001
1000000000000000000000000000000000000000000000000000000000000000000001
1000000000011111111111111000011111111110000000000000000000001111111111
1000000000000000000000000000000000000000000000000000000000000000000001
1000000000000000000000000000000000000000000000000000000000000000000001
1000000000000000000000000000000000000000000000000000000000000000000001
1000000000000000000000000000000000000000000000000000000000000000000001
1111111100000000000111111111111111111111111111111111111111111000011111
1000000000000000000000000000010000000000000000000000000000000000000001
1000000000000000000000000000010000000000000000000000000000000000000001
1000000000000000000000000000010000000000000000000000000000000000000001
1000000000000000000000000000010000000000000000000000000000000000000001
1111111111111111111111111111111111111111111111111111111111111111111111